xxxxxxxxxx
x  1111 bx
x 111111 x
x11111111x
x11111111x
x111b1111x
x11111111x
x 111111 x
x  1111  x
xxxxxxxxxx