xxxxxxxxxx
xa  111  x
x 1 1111 x
x11 11111x
x11 11111x
x11 11111x
x11 11111x
x 111111 x
x  1111  x
xxxxxxxxxx