xxxxxxxxxx
xa s111  x
x  h1111 x
xt1111111x
x11111111x
x11111111x
x11111111x
x 111111 x
x  1111  x
xxxxxxxxxx